11111111111111111
1E000000001000101
10000000101010101
1C000000101010101
10000000101010101
10000000101010101
10000000101010101
10000000101010101
10000000101010101
10000000101010101
10000000101010101
10000000101010101
10000000101010101
1P00000010001C101
11111111111111111
